222........................................................................................111
222........................................................................................222
222........................................................................................222
222........................................................................................222
222..........................222...........................................................222
222.....E...................2222.............................................................r
222........................22222..............................................................
222...P....SSSSS..........222222..............................................................
2222111111111111111111111222222211111111111111111111111111111111111111111111111111111111111222
2222222222222222222222222222222222222222222222222222222222222222222222222222222222222222222222
2222222222222222222222222222222222222222222222222222222222222222222222222222222222222222222222
2222222222222222222222222222222222222222222222222222222222222222222222222222222222222222222222