222.......................222
222.......................222
222.......................222
222.P.....................222
22211111111111111111111...222
22222222222222222222222...222
22222222222222222222222d..222
22222222222222222222222...222
22222222222222222222222...222