222...222222222222222222222222222222222222222222222222222222222222222222222222222222222222222222222222222222222222222
222.P.222222222222222222222222222222222222222222222222222222222222222222222222222222222222222222222222222222222222222
222...222222222222222222222222222222222222222222222222222222222222222222222222222222222222222222222222222222222222222
222...222222222222222222222222222222222222222222222222222222222222222222222222222222222222222222222222222222222222222
222...22222222222222222222222222222222222222222222222222222222222222222.............................................r
222...22222222222222222222222222222222222222222222222222222222222222222..............................................
222...22222222222222222222222222222222222222222222222222222222222222222..............................................
222...22222222222222222222222222222222222222222222222222222222222222222.................................1111111111111
222...22222222222222222222222222222222222222222222222...................................................2222222222222
222...22222222222222222222222222222222222222222222222...................................................2222222222222
222...22222222222222222222222222222222222222222222222...................................................2222222222222
222.............2222222222222222222222222222222222222...................................................2222222222222
222.............222222222222.......................................S..............................................222
222.............222222222222......................................SSS.............................................222
2221111111.......................................................S.S.S............................................222
22222222221........................................................S..............................................222
222222222221.......................................................S..............................................222
222222222222111111111111111111111111111111111111111111111111111111111111111111111111111111111111111111111111111111222
222222222222222222222222222222222222222222222222222222222222222222222222222222222222222222222222222222222222222222222
222222222222222222222222222222222222222222222222222222222222222222222222222222222222222222222222222222222222222222222
222222222222222222222222222222222222222222222222222222222222222222222222222222222222222222222222222222222222222222222