...................................................222222222
...................................................222222222
...................................................222222222
...................................................222222222
...................................................222222222
...................................................222222222
...................................................222222222
...................................................222222222
...................................................222222222
...................................................222222222
...................................................222222222
1111111111111111111111111111111111111111111111.....222222222
2222222222222222222222222222222222222222222222.....222222222
22222222222222222222222222222222222222222222221....222222222
2222222222222222222222222222222222222222222222.....222222222
2222222222222222222222222222222222222222222222.....222222222
2222222222222222222222222222222222222222222222.....222222222
2222222222222222222222222222222222222222222222.....222222222
2222222222222222222222222222222222222222222222...1.222222222
2222222222222222222222222222222222222222222222.....222222222
2222222222222222222222222222222222222222222222.....222222222
2222222222222222222222222222222222222222222222.....222222222
2222222222222222222222222222222222222222222222..1..222222222
2222222222222222222222222222222222222222222222.....222222222
2222222222222222222222222222222222222222222222.....222222222
2222222222222222222222222222222222222222222222.....222222222
2222222222222222222222222222222222222222222222....1222222222
2222222222222222222222222222222222222222222222.....222222222
2222222222222222222222222222222222222222222222.....222222222
2222222222222222222222222222222222222222222222.....222222222
2222222222222222222222222222222222222222222222.....222222222
2222222222222222222222222222222222222222222222.P...222222222
222222222222222222222222222222222222222222222211111222222222