............
............
.....P......
111111111111
222222222222
222222222222